1111111111
100001C101
1P11000111
1000010E01
1100000001
1111111111