1111111111
1P0001C101
1011000101
1000010E01
1100E0N001
1111111111