111111111111111111111111111111111111111111111111
1000000000000100000C00100010011100000001100N0011
10P0000111110000111111100C0000111000000110000001
100000000N000000C0000000000000000000000000000001
1000000000000000000000000000111100000000C110E011
1C00000000010111111100000000000000N0000000000001
111111111111111111111111111111111111111111111111